
F  50,100,50

C 0,0,100



NO ./textures/wall.xpm

SO ./textures/wall.xpm

WE ./textures/wall3.xpm

EA ./textures/wall3.xpm


111111111111
100000000101
101101111101
101000000101
101010001101
101010001101
101010N01101
101010010101
101000010101
101111111101
111111111101
100000000101
111111111111